imitate = bắt trước
spaciously = rộng dãi
inclement = độ cao
incited = Kích động
occurred = Xảy ra
incurred = phát sinh
spare = dự phòng 
abruptly = sudden = đột ngột
anthropology = nhân chủng học
double the original estimate. = gấp đôi ước tính ban đầu
prevalent = thịnh hành
resigned = từ chức
orchestration= dàn nhạc
Scale up = mở rộng quy mô
decouples = tách rời
coordinates= toạ độ
desired= mong muốn
facilities= Cơ sở vật chất
negotiations=Đàm phán
negative=Âm tính
Following weeks of negotiation = Sau nhiều tuần đàm phán
corporation= Tập đoàn
Our corporation= Tập đoán của chúng tôi
worn=rác nát
be worn = được mặc
Either=hoặc
inception=Khởi đầu
inherently= vốn có
magnificently=Tráng lệ
magnify=Phóng đại